NO ./texturse/greystone.xpm

SO ./texturse/wood.xpm

WE ./texturse/redbrick.xpm

EA ./texturse/bluestone.xpm

F 226,100,55

C 55,30,9

1111111111111111111111111111111111111111
     1111111110000000000000000001111111
        1010110000011100000000000111111
11111111111110111000000100011111111
11111111000001111100000010001
       1000001 100000001100011111111
    11110000111101000000000011111
11111111111111111100111111111
11111111111111111001111111111
10000000111100010000000001001
100000001  1001101010100S0001
100000001 1110000001110100001
111111111 1111111111111111111