NO     ./assets/bluestone.xpm

SO       ./assets/eagle.xpm

WE ./assets/floor_1.xpm

EA ./assets/purplestone.xpm


F 226,100,55

C 55,30,9

11111111
10100001
10100001
10100001
10000001
10S00101
10000001
11111111