NO ./texturse/greystone.xpm

SO ./texturse/wood.xpm

WE ./texturse/redbrick.xpm

EA ./texturse/bluestone.xpm

F 226,100,55

C 55,30,9

11111111
10100001
10100001
10100D01
10000001
10N00101
10000001
11111111